赛季首次连胜丁伟鼓劲全队连败不是我们水平新浪竞技风暴新浪网	体育
委内瑞拉应对高通胀发行六款新纸钞和三款新硬币委内瑞拉通胀钞票新浪财经新浪网	美股
贝克尔失利将激励小德再崛起	体育
融慧财经港股质素佳科技股寻宝港股中软金蝶新浪财经新浪网	财经
逆袭失败辽宁这坑没填上	体育
普京公开赞扬特朗普是聪明人	美股
四川主帅球队陷入困难期	体育
巩晓彬婉拒点评山东中途换外援是无奈之举新浪竞技风暴新浪网	体育
结盟失败消息称拒绝了的并购橄榄枝并购新浪财经新浪网	美股
小米成美国专利大买家排行榜上超华为小米专利华为新浪财经新浪网	美股
曝梅西劝告皇马万天王离开皇马	体育
美通过法案升级与台湾军事交流	军事
深交所深港通首日上午运行顺畅港股新浪财经新浪网	财经
国务院安委办煤价上涨	国内
泡椒复出助步行者横扫	体育
世界赛第次中国内战	体育
罗尔只是求救者不要用毫无节制的言论虐杀他罗尔求救者新浪新闻	其他
格力与野蛮人关系微妙	科技
对话快手宿华的幻觉	科技
厉害了女神韩雪全英文演讲韩雪演讲新浪娱乐新浪网	娱乐
陈曼娜女儿搂老公出门扫货	娱乐
新浪观影团岁未成年免费观影抢票新浪观影团岁未成年免费抢票新浪娱乐新浪网	娱乐
西城威尔士意大利公投失败	财经
马拉松已现起猝死	体育
张蓝心臂力堪比男兵	娱乐
张铎赞老婆球打得好	娱乐
百度机器人能和你聊新闻	科技
特朗普为何缓和对俄关系打压中国	军事
年体育产业年度评选候选名单新浪多项入围其他新浪竞技风暴新浪网	体育
地球上天生就会跑的民族	体育
斯巴鲁在大陆召回辆汽车	财经
日本最伟大球员	体育
非农差强人意	财经
特朗普鸡血推高市场	美股
天心闪婚后首露面	娱乐
防弹少年团个唱即将开票	娱乐
泳联年度最佳施廷懋陈艾森获奖	体育
爱达欧洲新危机爆发	财经
邦达亚洲公投所激发的避险情绪有限	财经
曼联前助教再给范加尔赛季	体育
瓦尔纳欧巡夺冠初体验请记者喝酒	体育
裸条借款者信息流出大多来自师范院校	科技
飞刀开播	娱乐
东部小威少复出就输鱼腩	体育
韩国国会预定周五表决弹劾案	美股
你的名字大卖	娱乐
留美学生涉性侵等项指控	社会
女子围甲赛季战全胜	体育
李小冉徐佳宁牵手过木栈	娱乐
黄晓明一家三口游台北	娱乐
华为公司被诉不正当竞争	科技
人物年前天之骄子低谷重生	体育
比赛变成老友会	体育
迪丽热巴晒度假风照片	娱乐
观点切尔西巨星已是英超最强	体育
人物传统定义的颠覆者	体育
内地票房你的名字首周亿夺冠内地票房你的名字神奇动物在哪里新浪娱乐新浪网	娱乐
浙媒林志杰划水打养生球	体育
传奇英超唯一世界级是阿圭罗	体育
广州主帅输榜首没什么	体育
收评商品持续上涨	财经
香港立法会名辱华侯任议员议席出缺香港立法会辱华新浪新闻	国内
振兴东北想起通钢事件苏州人和通钢人不一样新浪财经新浪网	财经
阿巴斯缺阵无碍同曦连胜	体育
詹天佑双色球期分布图一区首尾热度高彩票新浪竞技风暴新浪网	体育
纽约玫瑰香换一种姿态	体育
中国艘海警船今日进钓鱼岛巡航	军事
深港通正式启动	财经
该赢的球一场没丢	体育
亚太股市周一收跌	财经
米长虹赛季最佳一传小法这绝学坎特做不到英格兰新浪竞技风暴新浪网	体育
权威杂志评世界最佳罗称王	体育
老妖王胡雪峰又掌控比赛	体育
美媒称俄军打造独立加密互联网	军事
追婚记曝预告片	娱乐
意大利修宪公投失败	国际
以媒以色列尝试利用名人代言吸引中国游客以色列中国游客名人新浪新闻	国际
深股通净流入亿	财经
北京链家我爱我家等十大房地产中介被约谈新浪财经新浪网	财经
索尼笔记本电池组也有燃烧隐患	科技
月日点交易员正关注要闻要闻美股国际财经新浪财经新浪网	美股
伍兹下场比赛在哪	体育
逗妹吐槽穆帅助莫爷正名	体育
卡卡那些狂野的长途奔袭欧冠战曼联意大利新浪竞技风暴新浪网	体育
新浪彩票名家双色球第期推荐汇总彩票新浪竞技风暴新浪网	体育
小男孩成功拉起近斤杠铃	体育
不到长城非好汉	体育
欧洲股市周一全线低开	财经
格力电器龙虎榜深股通专用席位扫货近亿格力电器深港通新浪财经新浪网	财经
真人秀中不活跃林更新不想假林更新真人秀假新浪娱乐新浪网	娱乐
海翔药业终止收购新三板星鑫航天股权海翔药业新三板新浪财经新浪网	财经
梅西后巴萨下一个号可能是他	体育
星战空降广州	娱乐
全球化死亡之旅始于全球化新浪财经新浪网	股市
劳达怒批罗斯伯格退役决定	体育
人物最强火力成金州第护盾	体育
浪琴表香港国际赛事周将临	体育
神吐槽追梦踢人引发热议	体育
巨龙管业拟转	财经
女子围甲於之莹率江苏夺冠	体育
久保与二弦琴引进	娱乐
朴槿惠或明年月下台	国际
全国现大范围空气污染过程	国内
国象甲级联赛收官上海四度称霸	体育
龙虎榜深股通专用席位买入格力电器近亿格力电器深港通新浪财经新浪网	财经
华盛顿邮报西方统治时代已经结束全球化新浪财经新浪网	股市
乙二醇现货企业保值需求强烈乙二醇期货新浪财经新浪网	财经
韩国明年国防预算将涨	军事
日本岁甜美女偶像未婚先孕闪退演艺圈演艺圈日本川原结衣新浪娱乐新浪网	娱乐
月日上市公司晚间公告速递明日股市公告速递新浪财经新浪网	股市
华北制药冀中能源将以现金方式受让公司股权华北制药冀中能源新浪财经新浪网	财经
大商所黄大豆号政策扫除合约再造障碍大商所玉米期货新浪财经新浪网	财经
中化岩土拟亿参与发起设立九信人寿中化岩土金杯电工人寿保险新浪财经新浪网	财经
美银美林风向指标显示标普指数明年将暴涨美国股市标普新浪财经新浪网	股市
安倍将祭奠珍珠港事件遇难者	国际
韩月外汇储备近亿美元	股市
	娱乐
体坛风云人物国青男排罕见入围	体育
证监会光韵达等三公司并购重组获通过新浪财经新浪网	财经
格力地产推第二期员工持股计划	财经
格列兹曼拜仁没瓜帅时期强了	体育
十余位红二代红三代齐聚北京饭店为何事刘亚洲北京饭店红二代新浪新闻	国内
外交部回应美阻止中资收购德企反对将商业政治化新浪财经新浪网	财经
任市委书记落马造成的内伤有多重落马买官卖官河南新浪新闻	国内
中航地产亿向保利出售地产业务中航地产保利地产资产管理新浪财经新浪网	财经
曝德拉克斯勒遭狼堡队内禁赛	体育
新浪杯冠军战熟地黄抗日	体育
北京地铁更换新程序	社会
最美表演刘昊然特意蓄须	娱乐
梅雁吉祥最高检不支持公司的监督申请梅雁吉祥最高检股权新浪财经新浪网	财经
三江购物澄清新零售转型的相关报道三江购物零售阿里巴巴新浪财经新浪网	财经
曝皇马不满巴萨被裁判偏袒本可以领先更多积分西班牙新浪竞技风暴新浪网	体育
今日数据趣谈连场三双	体育
台当局砍假引恶战	国内
李克强破除各种不合理准入限制	财经
林忆莲上歌手回应约谈中没确定林忆莲我是歌手陈镇川新浪娱乐新浪网	娱乐
最美表演周冬雨表演就是用心和真诚最美表演周冬雨花絮新浪娱乐新浪网	娱乐
意大利公投未成英国脱欧和特朗普的翻版	美股
美元去杠杆的一个迹象已经显现银行业美元通货膨胀新浪财经新浪网	美股
山水获深圳派德及其一致行动人举牌	财经
盘前道指有望开盘便创历史新高美国股市新浪财经新浪网	股市
袁姗姗斥教练借马甲线宣传仅短暂授课微博袁姗姗马甲线新浪娱乐新浪网	娱乐
粤媒出两亿上港也不放武磊	体育
埃里克森中超中甲差距不大	体育
维泰尔否认接替罗斯博格空位我和都有合同赛车新浪竞技风暴新浪网	体育
虹桥一姐骗袁成杰后未受影响	娱乐
京媒嘉宾杨晨放当今至少值亿	体育
证监会严厉抨击野蛮人后	财经
叶江川联赛是培养新人的舞台	体育
开盘美股周一高开	美股
日媒特朗普将让中国告别世界工厂中国制造新浪财经新浪网	股市
融信全国单价地王引资	财经
穆帅安帅没做到的齐达内做到了	体育
红牛确信年将会挑战两项总冠军赛车新浪竞技风暴新浪网	体育
少年预告狠血性	娱乐
万达成为全球最大院线运营商	股市
邀请个产油国参加会议	美股
三少爷的剑江一燕逼自己变狠角色江一燕蒋梦婕林更新新浪娱乐新浪网	娱乐
健忘村王千源手握大权	娱乐
道指月大涨点	美股
野蛮人前海人寿遭扼现金咽喉	财经
张玉宁入荷甲当轮最佳阵容	体育
英国最高法院开庭审理脱欧程序案英国脱欧新浪新闻	国际
中南建设陷信披违规质疑千万元应付账款消失新浪财经新浪网	财经
正面与竞争宝马将提供无人驾驶汽车打车服务无人驾驶汽车智能手机新浪财经新浪网	美股
医院泄露吴亦凡检查报告	娱乐
除许达哲外	国内
好闺蜜杨幂祝唐嫣生快找到对你好的他微博新浪娱乐新浪网	娱乐
巴萨确认内马尔未受伤	体育
当今联盟头号科蜜续约母队就是为了致敬科比新浪竞技风暴新浪网	体育
微软年搜索对话框将彻底消失搜索对话框微软新浪科技新浪网	科技
奶茶妹妹与诺奖得主同坐	娱乐
频频爆炸	科技
外媒头条中国月服务业活动指数创个月最快增速中国服务业指数美国服务业指数意大利全民公投新浪财经新浪网	美股
视频网站会员付费暗藏玄机	科技
江西丰城发电厂事故调查施工方承认赶工期发电厂坍塌新浪新闻	国内
李小加深港通推动深港两地整体竞争力和吸引力王建军拓荒牛李小加新浪财经新浪网	财经
深港通首日只标的股逆市上涨	股市
山水万股即将开拍	财经
家上市公司发布年报预告	财经
深港通昨正式开通	财经
商人疑借官员之名诈骗万我嫂子是县委书记诈骗县委书记新浪新闻	社会
法国总统奥朗德放弃连任	国际
夏天满岁	娱乐
英媒人民币贬值缩小价差	美股
不嫌臭妙龄女上厕所时隔断下突现一张男人脸厕所偷窥新浪新闻	社会
贾樟柯助阵塔洛有万玛才旦不孤单贾樟柯赵本山塔洛新浪娱乐新浪网	娱乐
德媒乐高比黄金保值但在中国例外	美股
五人组团偷盗高速路隧道电缆	社会
岁女孩为救父亲严重烧伤	社会
居民入住年天然气没通	社会
意大利公投未通过	美股
失业率长期处于高位	美股
环保小李密会川普女儿送气候变迁纪录片	娱乐
卡主手机借他人信用卡被盗刷	社会
南美足联宣布沙佩科恩斯获南美杯冠军西班牙新浪竞技风暴新浪网	体育
手机临时号被用来做不法之事	社会
农业部部长加快推进农垦改革	财经
十三五生态环境保护规划发布	财经
经济透视美元升升不息	美股
人民币汇率短期料延续偏强震荡	财经
成都雾霾来袭	社会
罗曼蒂克程耳不惧排片再受万达打压杜江王传君葛优新浪娱乐新浪网	娱乐
足总杯第轮抽签结果出炉曼城苦战曼联好签英格兰新浪竞技风暴新浪网	体育
周一美油收高布油涨原油期货新浪财经新浪网	美股
金科股份控制权争夺战启幕孙宏斌有了新猎物新浪财经新浪网	财经
暴风冯鑫暴风如何避免烧钱新浪财经新浪网	财经
巴爷澄清夜店打人事件不要相信媒体的每句话新浪竞技风暴新浪网	体育
牟其中声称正推进南德集团复业	国内
特朗普扩大国务卿遴选范围	美股
人民日报刊文人民币资产全球吸引力增强人民币黑天鹅人民币国际化新浪财经新浪网	财经
清华系雷军系世纪互联私有化搁浅世纪互联雷军新浪科技新浪网	科技
收盘意公投之忧消退	美股
韩媒朴槿惠已接受提议	美股
阿里巴巴起诉刷单平台傻推网	美股
美联储布拉德月加息将是非常合理的选择财政政策失业率加息新浪财经新浪网	美股
隔夜国际市场要闻必读月日埃克森美孚国投电力朴槿惠新浪财经新浪网	美股
财政部考虑启动增值税立法	财经
国土部司局官员月来调整不少于名	财经
说起隔扣阿联他捂脸乐半天	体育
中船系股价集体异动	财经
月日点交易员正关注要闻利宝互助万能险蔡英文新浪财经新浪网	美股
送温暖巴萨盘路惨不忍睹	体育
欧冠末轮全解析队可作胆	体育
岁末机构调研进入密集期	股市
传刘士余与力推深铁入主万科的深圳官员近期有接触刘士余宝能万科新浪财经新浪网	财经
打军二代明星老公哭着道歉	国际
台主播大陆吃火锅不放料	国内
短池世锦赛徐嘉余项可冲金	体育
张敬伟深港通让资本市场再添活力和红利深港资本市场市场新浪财经新浪网	股市
钱江水利房产资产包网上司法拍卖	股市
湖南再曝万天价拖车费	财经
王菲确认加盟东方卫视跨年	娱乐
罗拿奖拿到手软啦力压梅西又获一世界最佳奖西班牙新浪竞技风暴新浪网	体育
切尔西美女球迷火了美国女学生乱入曼联大战英格兰新浪竞技风暴新浪网	体育
湖北煤矿发生瓦斯突出事故	国内
男子因万欠款多年讨要未果	社会
波耶特训练露出魔鬼一面	体育
度新鲜出炉面包内馅冰冷	财经
吉米坎摩尔将主持第届奥斯卡颁奖礼吉米坎摩尔奥斯卡主持新浪娱乐新浪网	娱乐
中国移动补卡程序有漏洞	财经
哈维罗涉逃税金额太惊人	体育
英媒称人民币贬值引发境外做空押注促中国收紧资本控制人民币做空资本控制新浪财经新浪网	美股
女环卫工遭岁女子暴打	社会
三星杯柯洁挑战蝉联新纪录	体育
林丹今晚迎出轨门后首战	体育
大表哥臀伤未愈至少再休周	体育
曝曼联高层坚定支持穆帅	体育
外媒称日本新导弹射程覆盖钓鱼岛	军事
胡枫念亡妻夜深人静很难捱	娱乐
下一代避孕套将会是什么样世界首富有答案避孕套盖茨基金会艾滋病新浪科技新浪网	科技
英纪录片称特朗普正动员大规模战争	军事
前海人寿回应万能险风波力争月日前完成整改新浪财经新浪网	财经
安倍首访珍珠港向美国表忠诚	军事
块钱换万保障网络互助刚兴起	科技
惨曼联现在最怕弗格森时间	体育
老中医遭顾客持刀威胁受惊猝死	社会
水晶男孩新专发行	娱乐
巴萨西甲冠军这次悬啦从未跨越过皇马分鸿沟西班牙新浪竞技风暴新浪网	体育
世界排名伍兹飙升位	体育
英媒称美用个军事基地包围中国	军事
中国保险报险资不是妖精	财经
孤芳曝预告片	娱乐
拜仁大将亲承曾非常接近加盟曼联	体育
林依晨频摸小腹被疑有孕是一种安全感林依晨怀孕老公新浪娱乐新浪网	娱乐
央行今日展开亿逆回购操作	财经
佬牛解盘巴黎巴萨作胆	体育
男子与妻拌嘴求回应	社会
第五届中国校园戏剧节闭幕	娱乐
巴萨下赛季主客场球衣已曝光	体育
第三方机构公布三星爆炸原因	科技
俄机接连坠海因一设计缺陷	军事
常规赛赔率库里赔掉队	体育
炒原油能赚大钱吗先让你赚万再让你亏万原油新浪财经新浪网	财经
刺激巴黎青年火车顶冲浪	体育
王宝强回乡诉演艺艰辛	娱乐
常石磊我我首发	娱乐
岁辣妈跑完南北两极马拉松	体育
摆脱实体手柄	科技
朋友圈最新十大谣言美国新总统老家在四川省自贡市朋友圈谣言微信新浪科技新浪网	科技
已婚女寻刺激出轨后离婚	社会
加拿大小将获田联最佳新秀	体育
意大利公投加大政治风险	美股
球队排名恒大分优势返亚洲第	体育
郭家耀料恒指维持至点水平徘徊中国银盛恒指新浪财经新浪网	财经
快讯善源控股再冲高破元	财经
尹均相出演新剧逆贼	娱乐
决战食神主题曲谢霆锋携英皇群星嗨唱谢霆锋葛优决战食神新浪娱乐新浪网	娱乐
中国一造船厂火力全开正同时造艘神盾舰图中国海军驱逐舰北海舰队新浪军事新浪网	军事
爱跑步你的膝盖同意吗	体育
年城市服务业高薪榜出炉	国内
瓜迪奥拉不担忧输给切尔西	体育
佩小姐嘲讽了麻木的成人世界佩小姐爱娃格林巴特菲尔德新浪娱乐新浪网	娱乐
一个冬天不跑步身体如何变化	体育
今冬韩剧找看点最强男男不容错过鬼怪花郎	娱乐
迪士尼华纳幸免好莱坞哪些片最亏好莱坞迪士尼钢铁骑士新浪娱乐新浪网	娱乐
印度海军米长护卫舰翻船	军事
姚明爱女姚沁蕾又长个了	体育
王子文精神穿越曲筱绡许诩都是我王子文如果蜗牛有爱情欢乐颂新浪娱乐新浪网	娱乐
两名小伙为争女友械斗	社会
特朗普指责中国令人错愕	军事
跑步时脚步很沉怎么办	体育
英锦赛综述丁俊晖三大赛低迷	体育
保监会出手	科技
佩小姐童话世界的黑色打开方式孤儿院佩小姐佩小姐的奇幻城堡新浪娱乐新浪网	娱乐
影响跑步质量的元凶关注不是伤病的伤病	体育
交响京剧大唐贵妃重演	娱乐
男主和男二也太甜好想站这对基友鬼怪韩娱孔刘新浪娱乐新浪网	娱乐
向佐亦航感情持续升温	娱乐
央行展开亿逆回购操作	财经
外媒评人工智能十大失败	体育
数据解读中超武磊一直在进步	体育
西部骑术中的盛装舞步	体育
资深驴友三峡徒步失联	体育
日本将重启海军陆战队与中国夺岛	军事
五大囧索大腿和亿元先生超囧快攻	体育
温格谈两大腿续约也许我太天真了	体育
周董中断拍摄批节目组没礼貌	娱乐
谷歌发布年最佳应用榜单前五估计你都没用过谷歌应用新浪科技新浪网	科技
延边冬训看点谨防斗志变淡	体育
流言揭秘黑暗中看手机易失明不至于失明视力眼科新浪科技新浪网	科技
剧组回应王源天台无防护拍戏	娱乐
山东新援战旧主上海或首秀	体育
巴萨大将落后皇马分不算太多	体育
王源回应天台事件栏杆外有平台还挺安全我们的少年时代王源新浪娱乐新浪网	娱乐
高原登山小百科忌讳单独行动	体育
对话伊一不会离开浙江台	娱乐
硅谷年度科学突破奖出炉	科技
大宗商品涨势加固	美股
西蒙尼想去国米执教本人确认	体育
巴萨低迷真相射门差到极点	体育
存有粗俗文件	体育
日本主导废除核武器决议案获通过	军事
巴黎马术大师赛落幕浪琴大奖赛比利时骑手称王马术新浪竞技风暴新浪网	体育
北京明年将实施世界最严锅炉排放标准	国内
残暴雷霆二哥折叠扣辱魔兽	体育
奥运汤加爆红旗手欲战冬奥会	体育
穆里尼奥的借口和齐祖的命硬英格兰新浪竞技风暴新浪网	体育
港媒称中国开发新技术助潜艇实现隐形	军事
大学生本想花元烫个发	社会
我在故宫修文物主创畅聊工匠精神我在故宫修文物萧寒姚谦新浪娱乐新浪网	娱乐
倒数第三也算成功	体育
招银国际南下资金少	财经
贝托鲁奇回应强迫女星拍强奸戏丑闻误解巴黎最后的探戈玛利亚施奈德贝纳尔多贝托鲁奇新浪娱乐新浪网	娱乐
仿星器磁场强度达设计峰值误差不到十万分之一磁场核聚变等离子体新浪科技新浪网	科技
火车头因资金不足数次搬家次更名	体育
快讯	财经
本山传媒艺术总监刘双平养生就是靠忙小沈阳赵本山本山传媒艺术总监新浪娱乐新浪网	娱乐
岁老太苦寻杭州初恋	社会
赔惨了细数年扑街的续集电影续集扑街爱丽丝新浪娱乐新浪网	娱乐
这些不为人知的背后故事	体育
鲁能泰山球员赛季总结之蒿俊闵多线作战最疲劳一季中超新浪竞技风暴新浪网	体育
梅西剑指罗目标破两大欧冠纪录西班牙新浪竞技风暴新浪网	体育
鲁能泰山球员赛季总结之成源预备队金靴能改命运中超新浪竞技风暴新浪网	体育
沃尔奇才止连败	体育
巴西对华合金钢条反倾销终裁并征税新浪财经新浪网	财经
健忘村曝预告	娱乐
冻龄女星宁静都是骗人的	娱乐
邦达亚洲意大利公投影响有限	财经
嘉盛集团澳元美元测试关键阻力位	财经
冯珊珊本周迎迪拜卫冕战	体育
大众成立类似的服务部门	科技
苏宁年套票正式预约	体育
三分板詹皇外最粗的大腿	体育
蔡珩如果蜗牛深情演绎反派爱情如果蜗牛有爱情王子文王凯新浪娱乐新浪网	娱乐
私房菜安徽开播	娱乐
发布已有三个月	科技
费德勒小威退出表演赛	体育
柳传志我没有马云那么阔	科技
澳大利亚央行维持利率不变	美股
中国最牛军校培训出国外军高官	军事
牛汇月日亚欧纽时间段交易提醒零售业欧元区新浪财经新浪网	财经
艾拓思官员讲话再压金价	财经
兄弟受伤逼詹皇新高	体育
岁最老亚巡冠军来不及办护照	体育
秦岚拍相爱被真打	娱乐
惊曝皇马双星涉嫌偷税万	体育
快讯深股通净流入亿	财经
古永锵我看到的未来是融合和链接古永锵优酷新浪科技新浪网	科技
德国总理默克尔将号召党内团结	美股
肘击悍将登哥险些葬送胜局	体育
何沐妮首次出战迪拜大师赛	体育
黑龙江杀辅警焚尸嫌犯割腕自杀	国内
飞天窑女曝预告	娱乐
王石四十周年时万科营业额预计可达万亿王石万科新浪科技新浪网	科技
优步收购人工智能初创公司并创建人工智能研发部人工智能自动驾驶汽车新浪科技新浪网	科技
李开复未来年人工智能公司将出最多独角兽李开复创新工场新浪科技新浪网	科技
保险获万美元轮融资融资保险新浪科技新浪网	科技
午评港股恒指涨	财经
干扰球助马刺险胜雄鹿	体育
我们的挑战阮经天大秀身材把妹撩阮经天刘烨岳云鹏新浪娱乐新浪网	娱乐
侠盗一号定档	娱乐
必胜客连胜挡不住之队	体育
午评深股通净流入亿	财经
王石公司业绩可持续增长比翻番增长更重要新浪财经新浪网	财经
网红佩琪不惧死亡威胁再战迪拜姑娘们当自强赛新浪竞技风暴新浪网	体育
踏破关詹皇新高夜又创纪录	体育
连续场威震天溜达着拿历史第	体育
松半口气疼哭的妖枪并未骨折	体育
惨火箭大副遭黑贝误伤离场	体育
沪股通半日录近亿人币流入沪股通流入新浪财经新浪网	财经
联合国未通过叙利亚停火天决议草案	军事
西布对抗全联盟	体育
边境足球故事球队穿越战火参赛	体育
印尼将南海一区域划为其专属经济区印尼南海中国新浪军事新浪网	军事
巴黎为应对空气污染	国际
遭廉价手环冲击苹果手表三季度销量预计同比暴跌苹果手表	美股
怪咖火箭绿军藏俩左撇子	体育
北京一宝马车深夜冲撞公交站乘客	国内
印度海军惨剧频发	军事
罚中万瓷王竖起碰瓷丰碑	体育
新浪观影团反黑行动组免费观影抢票新浪观影团反黑行动组免费抢票新浪娱乐新浪网	娱乐
月日点交易员正关注要闻美股国际财经要闻新浪财经新浪网	美股
银魂海报曝光	娱乐
内线被爆别急火箭救星这就来	体育
谢娜回应不生孩子的原因忙不过来没时间谢娜张杰催生新浪娱乐新浪网	娱乐
徐翔等三人操纵证券市场案一审三人均认罪	财经
徐翔一审开庭审理	国内
徐翔实际控制近百人证券账号利用信息优势操纵股价徐翔操纵证券案新浪财经新浪网	财经
获万美元融资提供基于机器学习的营销工具融资机器学习新浪科技新浪网	科技
巴西参议长因涉嫌挪用公款被罢免巴西官员贪腐新浪新闻	国际
脸书早期投资方又募集亿美元资金电子商务新浪科技新浪网	科技
皇马更衣室立誓时隔年为皇马赢下双冠西班牙新浪竞技风暴新浪网	体育
女跑者寒冬旷野历险记	体育
消息称三星和现代掌门人将接受韩检方质询三星现代新浪科技新浪网	科技
唐嫣罗晋情路回顾多次否认然而真爱难掩罗晋唐嫣恋情新浪娱乐新浪网	娱乐
遭廉价手环冲击苹果手表第三季度销量预计同比暴跌手表苹果新浪科技新浪网	科技
程维第二个五年把滴滴打造成世界级的科技公司滴滴程维新浪科技新浪网	科技
队史第残暴分写进历史	体育
哭晕步行者耻辱纪录遭刷新	体育
阿扎尔我拿最佳球员科斯塔拿最佳射手	体育
亚开行中国牵头的应迅速推进	美股
巴萨球迷抱怨皇马球迷咋能坐到巴萨死忠看台西班牙新浪竞技风暴新浪网	体育
队友小法该留切尔西	体育
台湾借网红刺激旅游	体育
你的名字破亿	娱乐
申花损大将高迪脚趾骨折离队治疗	体育
路威分残阵湖人遭三连败	体育
林志杰教小弟打得更自私一些	体育
宋佳深短皮裙性感优雅	娱乐
勇士碾压湖人联盟榜首	体育
史上最美搏击宝贝登陆中国	体育
名哨穆帅场边怒摔	体育
三星杯决赛首局柯洁不敌柁嘉熹	体育
战胜瓜迪奥拉最怕的名字不是穆帅	体育
助断他险助球队创历史	体育
先见之明唐嫣罗晋月份曾被拍亲密牵手唐嫣罗晋恋情新浪娱乐新浪网	娱乐
谁能岁夺世锦赛冠军	体育
传奇纠纷再次发酵	科技
分钟分什么水平他就是百分之夜的张伯伦新浪竞技风暴新浪网	体育
给分先生降降火库里整袋冰倒汤神头上新浪竞技风暴新浪网	体育
撩妹新模式黄子韬版太阳的后裔有毒黄子韬宋仲基太阳的后裔新浪娱乐新浪网	娱乐
曝皇马万报价新伊布遭拒	体育
支付宝登陆北极圈	美股
俄军新型万吨大驱已完成基本设计	军事
印度抓逃税抓出隐藏首富	美股
日股全日升	财经
背靠背此湖人真不是科比	体育
冉莹颖随夫健身	娱乐
切尔西利物浦争购万铁腰	体育
姆希塔良被穆帅练的肌肉暴涨	体育
村上春树的条跑步哲学	体育
新鸿基金融料港股明年上望点新鸿基金融港股上望新浪财经新浪网	财经
三双比肩哥哥	体育
消息称乐视体育裁员	财经
数据硬件创企获万美元轮融资高管服务器新浪科技新浪网	科技
唐嫣公开恋情	娱乐
唐嫣关注育儿账号回应没有怀孕唐嫣罗晋恋情新浪娱乐新浪网	娱乐
台当局证实大陆军机首次绕行台湾	国内
我们的挑战岳云鹏演技浮夸忽悠刘烨岳云鹏刘烨我们的挑战新浪娱乐新浪网	娱乐
独家对话变主演老朋友新面孔变形金刚马克沃尔伯格主演新浪娱乐新浪网	娱乐
看看球星小时候咋踢球	体育
岩田宽到底教了松山什么	体育
快讯港股通概念股表现活跃	财经
妖星神球	体育
收评乐视网暴跌近盘中接近跌停	财经
快讯深股通净流入亿	财经
美国人形机器人能走梅花桩	科技
印度将帮助越南训练苏战机飞行员	军事
曾轶可沈阳开唱展稳健唱功	娱乐
韩国天王热刺能立足于欧冠	体育
短信提醒功能制造汇款假象	科技
同样每天吃	体育
父子俩驾机动三轮车撞倒老人后	社会
乐视体育宣布架构和人事调整	科技
快讯港股通新贵中国罕王点燃市场热情	财经
理想音乐节三亚站日开启	娱乐
逆转之王切尔西落后抢分英超称王	体育
海上钢琴师男星自曝父子遭爷爷性侵海上钢琴师战争地带蒂姆罗斯新浪娱乐新浪网	娱乐
前海人寿上海银保万能险产品今起停售新浪财经新浪网	财经
拉奥尼奇收获生涯最佳赛季	体育
全球加速步入无币化时代大家都在和钱过不去无币化时代新浪财经新浪网	股市
冯静否认曾介入邓超郝蕾恋情没闲心闲情冯静邓超郝蕾新浪娱乐新浪网	娱乐
梅西戏耍众球星犯罪瞬间罗也成陪衬西班牙新浪竞技风暴新浪网	体育
新浪彩票名家大乐透第期推荐汇总彩票新浪竞技风暴新浪网	体育
台军幻影战机零件断供被指将退役	军事
狂欢勇士商店降价庆汤神分	体育
中国德比杯在即	体育
林永健时隔六年再上春晚	娱乐
年最佳比赛纳达尔奉献三场赛事新闻新浪竞技风暴新浪网	体育
新华时评呼死你是病得治呼死你新浪科技新浪网	科技
浙江富润出售上峰水泥万股	财经
女子围甲成肥沃土壤	体育
逗妹吐槽英超食物链形成	体育
月日点交易员正关注要闻格力电器债市徐翔新浪财经新浪网	美股
保级战陈一鸣力克李赫	体育
吉媒火车头退出吉林应递补	体育
莱德杯欧洲队近年队长回顾	体育
汇丰第三季度增持阿里股票达万股	股市
收评深股通净流入亿	财经
新集参股公司皖天然气获批参股新浪财经新浪网	财经
相爱三大蝴蝶效应	娱乐
收评港股恒生指数涨	财经
巴黎上演级别金杯赛	体育
思捷港零售最坏情况已过	财经
攀岩之路亚洲双料冠军仁青拉姆的十年户外频道新浪竞技风暴新浪网	体育
太平洋母公司月净利润环比大增太平洋环比净利润新浪财经新浪网	财经
三大赛又来了大师赛丁俊晖盼突破	体育
正在视频直播女排联赛第轮	体育
中南文化万增资影视娱乐公司中南文化新浪财经新浪网	财经
德尚博格巴无须有压力	体育
纳达尔男网将迎更新换代	体育
近名在菲被捕中国公民保释	国内
中科三环目前已开始为特斯拉提供产品中科三环特斯拉新浪财经新浪网	财经
第一届百所高校赛上财一队夺冠	体育
湖北巴东煤矿事故已致人遇难	国内
新鸿基金融港股股化无可避免	财经
中国外汇储备料跌向万亿美元关口	美股
香港第三季港口货物吞吐量按年升香港吞吐量按年升新浪财经新浪网	财经
曼城大将希望梅西来曼城	体育
新湖中宝实控人直接持股比例升至新湖中宝持股比例新浪财经新浪网	财经
运动员禁食表惨火锅烧烤各种肉统统不能吃新浪竞技风暴新浪网	体育
鹿晗确定加盟央视春晚	娱乐
李在镕否认三星有代价资助崔顺实之女三星李在镕新浪科技新浪网	科技
火车头俱乐部突然抛锚	体育
央行对家金融机构开展亿元操作新浪财经新浪网	财经
华尔街研报改走奇葩路线大胆逗趣成清流新浪财经新浪网	美股
资方代表谢文坚离场	股市
监管层清剿温州券商配资温州三单位辟谣新浪财经新浪网	财经
嘉吉严格风控百年农企的秘密武器大商所农产品公司产业新浪财经新浪网	财经
一张距今年的裸照	体育
聂卫平於之莹连奏凯歌	体育
一张图展示西方旧秩序的终结意大利总理伦齐新浪财经新浪网	股市
尚雯婕电子新作黑金上线尚雯婕黑金专辑新浪娱乐新浪网	娱乐
一秒变迷弟库里找汤神要签名这太不科学了新浪竞技风暴新浪网	体育
库克反驳报告	科技
厉害了我的姐	体育
美英指责中俄否决涉叙利亚决议	国际
魅族去年亏损亿元后	科技
月日上市公司晚间公告速递明日股市公告速递新浪财经新浪网	股市
华谊兄弟终止收购英雄互娱股份	科技
马骏发展绿色金融需要大力培育绿色投资者新浪财经新浪网	财经
爱达欧洲危机暂停息	财经
俄军称苏坠海不会影响海外作战	军事
英国黑胶专辑销量史上首次超过数字专辑黑胶唱片唱片数字专辑新浪娱乐新浪网	娱乐
北上资金持续买入格力电器	财经
国务院力促农民增收撬动社会资本投向农业农村农业保险农业农产品新浪财经新浪网	财经
投毒冤案保姆获赔款到手先还伸冤借的钱冤案投毒保姆新浪新闻	社会
埃里克森直言冲超充满难度有信心我们拭目以待吧中甲新浪竞技风暴新浪网	体育
恋爱真美矛盾升级	娱乐
兰亭集势月日发布第三季度财报兰亭集势财报新浪科技新浪网	股市
俄方称俄在叙医院遭炮击	国际
央行刊文人民币汇率有条件保持基本稳定新浪财经新浪网	财经
老公被曝是地主侯佩岑财务独立不聊这个侯佩岑天心地主新浪娱乐新浪网	娱乐
工人在工地被砸成重伤治疗费用遭拖欠重伤拖欠工人新浪新闻	社会
月日点交易员正关注要闻债市沪指麦当劳新浪财经新浪网	美股
华锦股份控股股东关联方减持万股华锦股份控股股东大宗交易新浪财经新浪网	财经
长城汇理转让天目药业股权并非因公司终止重组天目药业股权新浪财经新浪网	财经
槙野之外另有强人中超队盯上日主力国脚中卫中超新浪竞技风暴新浪网	体育
解局书记省长一肩挑天	国内
滴滴出行张博明年首次拓展国际市场业务滴滴海外市场张博新浪科技新浪网	科技
势不可挡李静分浙江女排上海	体育
银河证券温州市锦绣路营业部配合调查温州帮银河证券锦绣路新浪财经新浪网	财经
维维股份欲剥离房地产业务	财经
丈夫爱女装妻子离婚遭驳	社会
一家六口遇害尸横屋内	社会
文化部网游需公示道具抽取或合成概率网游监管文化部新浪科技新浪网	科技
挑战驳回丁霞再与裁判争执	体育
红球三连号二区断区	体育
场地越野厦门站预赛次轮童振荣夺飞车王赛车新浪竞技风暴新浪网	体育
喜剧九大神兽东北往事预告海报双发王迅九孔贾乃亮新浪娱乐新浪网	娱乐
奔驰拟在华生产电池和电动汽车戴姆勒新能源汽车欧元新浪财经新浪网	美股
上海副市长周波任市委常委	国内
泰达人员新季将变脸	体育
围棋培训中心假证事件非个例	体育
央行票据交易所位于上海	财经
传国安等队有意申花前锋高迪	体育
月日点交易员正关注要闻债市前海人寿逆差新浪财经新浪网	美股
疑马蓉为女儿微博改名	娱乐
富国银行市场预期错了美联储加息美元将下跌美元汇率新浪财经新浪网	股市
性侵中国留德女学生嫌疑人被捕	国际
东航被诉以公司计划为由突然取消航班	财经
开盘美股周二高开	美股
域名管理公司	股市
孙莉陪黄磊过第个生日	娱乐
三少爷徐克尔冬升用打造最好江湖尔冬升徐克林更新新浪娱乐新浪网	娱乐
销魂澳洲猛男回球失误发怪声	体育
扬科遭双杀	体育
儿子贪玩店里摔坏手机	社会
全球最古老银行准备接受政府救援意大利锡耶纳牧山银行政府救济欧洲金融业新浪财经新浪网	美股
特朗普安保成本太贵	国际
地方债风险应急处置预案出台债务分类管理	财经
股价跳水	科技
朱婷回国了不辞辛苦为代言品牌拍广告显风范排球新浪竞技风暴新浪网	体育
被称是骑士连败真凶	体育
安以轩登顶热搜一脸懵我在家啃大闸蟹微博安以轩胡歌新浪娱乐新浪网	娱乐
人民币没有暴跌	美股
城市任市委书记落马	国内
今日数据趣谈汤神超科比	体育
比约恩正式获选为欧洲队队长	体育
空砍分张常宁恼火自责打得太着急过于急躁排球新浪竞技风暴新浪网	体育
菲律宾总统再次禁止一阁员参加内阁会议菲律宾总统内阁会议新浪新闻	国际
春兰杯江苏淮安站有奖竞猜	体育
长城众星全亮相	娱乐
外媒头条人民币暴跌是谣言人民币微软麦当劳新浪财经新浪网	美股
小摩公司第四季度交易收入至少增长摩根大通美国大选高盛集团新浪财经新浪网	美股
高管被捕承诺难兑现	科技
倒闭潮之后	科技
男子因与人相撞争执	社会
林丹出轨门后人气不减	娱乐
俞觉敏杨珺菁带伤上阵要表扬	体育
闹僵立陶宛神锋拒绝火箭体检	体育
加提蓬拿出拼命的决心才赢	体育
裁员乐视体育称整体优化人员乐视贾跃亭乐视网新浪科技新浪网	科技
英雄互娱估值暴增价格没谈拢	科技
台当局正式修法砍天假	国内
皮克斯墨西哥亡灵节动画剧照曝光剧照动画片新浪娱乐新浪网	娱乐
洛杉矶警方收到恐怖袭击威胁	国际
青海玉树治多县发生级地震	国内
十三五环境治理目标和任务落实一水一山照着清单管环境治理环境质量清单式管理新浪财经新浪网	财经
餐桌外的浪费中国在储藏等环节年损粮食亿斤粮食粮食浪费新浪财经新浪网	财经
特朗普孙正义答应在美国投资亿美元孙正义美元特朗普新浪财经新浪网	美股
产油国产量创新高	美股
金价周二收跌	美股
传承访雄鹿亲自指点字母哥	体育
海外机构专家看好中国经济积极发展将惠及全球中国经济经济发展改革新浪财经新浪网	财经
男女因做减肥手术相识	社会
身价榜单罗跌出前三内马尔力压梅西位列第一西班牙新浪竞技风暴新浪网	体育
收盘等待联储会议	美股
欧冠强已晋级队皇萨仁领衔	体育
隔夜国际市场要闻必读月日美元人民币油价孙正义新浪财经新浪网	美股
印尼苏门答腊岛北部发生级左右地震印尼苏门答腊岛地震新浪新闻	国际
美最高法院就设计专利案作出利于三星裁决苹果公司三星新浪科技新浪网	科技
深改组着眼国有资本布局	财经
特朗普今年月已抛光所有股票	美股
争气阿森纳扼住命运咽喉	体育
金沙江创投朱啸虎谈投资死亡谷过后再进入滴滴创业者创投新浪科技新浪网	科技
月日四大证券报头版头条内容精华摘要四大证券报上证报中证报新浪财经新浪网	财经
烧钱狂奔难以为继	科技
股价跳水创新低	科技
成立实验室要造会飞的汽车人工智能新浪科技新浪网	科技
欧佩克限产油价大涨近	财经
梅西疾速狂飙只差罗球	体育
瓜迪奥拉讽裁判漏判点球哪天才给每场都这样英格兰新浪竞技风暴新浪网	体育
煤电长协欲拉铁路入伙	财经
鞍钢本钢合并传闻再起或年底公布	财经
温格毒啊白菜价捡阿森纳饼王	体育
河北钢坯价格同比上涨逾八成	财经
美称中国正飞速改造东南亚	军事
男子离婚两年拒见亲生子	社会
厉害了诺伊尔跑到中场打二过一组织进攻德国新浪竞技风暴新浪网	体育
曝男子中彩票巨奖朝女老板撒尿殴打被拍组图彩票新浪竞技风暴新浪网	体育
甜蜜郜林的幸福假期与爱妻游意大利	体育
年寒冬会过去吗创投的十个关键词上	科技
故弄玄虚	体育
实在没钱了	美股
被曝赴台生产黄晓明悄派人探勘医院黄晓明新浪娱乐新浪网	娱乐
张外龙力帆需引进国脚级球员	体育
阿森纳最强双王为加薪逼宫	体育
盘口巅峰战广东或输球	体育
惨西部垫底队首发中锋至少休天	体育
姚明岁女儿身高惊人	娱乐
环球时报特朗普别受猪队友蛊惑与中国对抗台湾特朗普新浪新闻	其他
欧冠足彩彩果阿森纳巴萨均大胜	体育
苹果推出电视应用统一登录工具苹果电视业界新浪科技新浪网	科技
乐视体育拟缩编裁员	科技
已婚男自称警察欲投资做生意	社会
虔诚张外龙跪地为球队祈祷	体育
熊黛林自拍秀性感酥胸	娱乐
格力电器二级市场惊魂记	财经
美国准国防部长曾对华强硬表态若冲突奉陪到底马蒂斯特朗普中国新浪军事新浪网	军事
举牌方夺权董事会	财经
申花冬训遭遇非战斗性减员	体育
陈凯琳否认和郑嘉颖分手我们感情很好郑嘉颖分手陈凯琳新浪娱乐新浪网	娱乐
公众号大咖你们得的打赏纳税了吗纳税公众号所得新浪新闻	其他
生意好谈价格难撮	财经
澳大利亚经济三季度萎缩程度创近八年最大澳大利亚新浪财经新浪网	美股
法国大奖赛年重返	体育
别让手机小号成违法行为帮凶侮辱纠纷投诉新浪新闻	其他
打记者抢器材鹿邑法院在遮掩什么冲突权力新浪新闻	其他
盲目力量训练	体育
国内民爆市场利润下滑	股市
中航系资产整合动作频频	股市
首艘国产航母最新卫星照曝光	军事
巴萨被放弃之人满血复活	体育
伪市场滋生了天价拖车费这样的怪胎政府权力新浪新闻	其他
乐视体育整体优化人员	股市
九球世界冠军付小芳生双胞胎	体育
七旬老人单骑闯西藏	社会
外媒称日本应重回亚洲	军事
曼联悍将为穆帅开脱表现不好怪我	体育
日本将重启陆战队要与中国拼夺岛	军事
欢喜传媒向电影人顾长卫及导演张晓陵配股欢喜传媒顾长卫配股新浪财经新浪网	财经
外媒博塔斯成梅奔首要候选	体育
王源天台无防护拍戏剧组遭指责真不冤王源我们的少年时代天台新浪娱乐新浪网	娱乐
晓明别看孤芳要虐钟汉良千万遍钟汉良孤芳不自赏新浪娱乐新浪网	娱乐
乐视网拟披露重大事项	财经
申万宏源预料恒指短期可望回升至近水平申万宏源恒指新浪财经新浪网	财经
曝中超万磅周薪报价桑切斯	体育
快讯港股恒指高开涨	财经
期指今早高开点	财经
有害电子垃圾处理不当苹果支付与加州环保署万美元苹果电子垃圾环保新浪科技新浪网	科技
竞彩大势皇马多特争头名	体育
第一上海短期倾向反复偏稳	财经
佬牛欧冠次日解盘热刺主场防平	体育
乐视网拟披露重大事项	科技
琅琊榜第二批演员公布暗藏玄机张慧雯琅琊榜李佳新浪娱乐新浪网	娱乐
市民买房年仍没拿到房产证	社会
梁渊料港股稳固或随股表现	财经
裸条放贷者谈肉偿客户都是有钱人裸体照片新浪科技新浪网	科技
环境污染降低国人生殖力	科技
专家质疑明星商业价值榜没郎平名字情何以堪排球新浪竞技风暴新浪网	体育
火箭匹配悍将合同藏玄机	体育
十七岁宣传片	娱乐
恋情公开很意外唐嫣罗晋早有三世情缘唐嫣杨幂刘诗诗新浪娱乐新浪网	娱乐
印尼总统佐科人民币成为标准外汇最适当印尼人民币外汇新浪财经新浪网	美股
科普火箭莫泰闹剧的四条支线	体育
德国大师赛傅家俊希金斯晋级	体育
方文山携周杰伦玩跨界	娱乐
低调中打脸他已渐入佳境	体育
流言揭秘白头发拔一根长十根说法不科学流言揭秘毛发白化病新浪科技新浪网	科技
萨利机长伊斯特伍德特问候中国观众萨利机长汤姆汉克斯克林特伊斯特伍德新浪娱乐新浪网	娱乐
亚马逊日本仓库引进机器人技术提高效率亚马逊物流新浪科技新浪网	科技
帕帅报销无厘头乌龙让你笑	体育
携双主打回归	娱乐
亚洲杯冠军可获千万美元	体育
球迷赴客场为孙悦庆生	体育
分先生揭人生第悔科比分我有票	体育
特斯拉因过热事故召回部分充电器特斯拉召回充电器新浪财经新浪网	美股
四俱投一个球能和谐共存勇士交完美答卷新浪竞技风暴新浪网	体育
吴亦凡加盟江苏跨年	娱乐
英皇证券恒指缓慢向上	财经
辽媒继续过度依赖老哈	体育
苏炳添总结目标已完成	体育
月日点交易员正关注要闻彭博要闻新浪财经新浪网	美股
欧冠次日解析尤文取胜锁第一	体育
大衣开了线的张朝阳与搜狐的下一站	科技
岁老人将世界纪录缩短近分	体育
分析人士乐视网若出现融资爆仓或引发恐慌性撤退乐视网贾跃亭新浪科技新浪网	科技
郭家耀预料指数继续於至点上落中国银盛恒指新浪财经新浪网	财经
腾讯要把提示音注册商标被驳回	科技
吉媒北京新人难觅全靠老将	体育
检察日报裸条借贷受害者	国内
央媒痛批裸条受害大学生消费观价值观畸形裸贷大学生新浪新闻	其他
为啥冬天每周至少外出跑次	体育
长城发布会林更新斗饕餮变智慧担当林更新张艺谋长城新浪娱乐新浪网	娱乐
可口可乐谨慎到认可	财经
从顺位到风城之主	体育
收购数字化工作室	科技
黑色越野车撞人后逃逸	社会
国产手机海外专利之困与在印度被诉国产手机新浪科技新浪网	科技
多伦多铁三节立新规	体育
南华金融恒指短线见底	财经
刘德华长城戏份没删	娱乐
任贤齐不穿内裤骑单车	娱乐
朴泰桓短池世锦赛首冠	体育
林丹出轨门后首秀受热捧	体育
工信部发布智能制造十三五规划	科技
打节能得分	体育
外媒欧盟若不给中国市场经济地位	美股
安帅赢马竞提升拜仁信心	体育
俄媒年俄将出现开发北极矿藏的水下机器人原型机矿藏原型机冰山新浪科技新浪网	科技
贝克尔透露不再执教原因小德全满贯后训练不刻苦赛事新闻新浪竞技风暴新浪网	体育
主场不败碰撞客场全胜	体育
间谍同盟服装设计手稿掀时尚复古潮玛丽昂复古间谍同盟新浪娱乐新浪网	娱乐
葛优告旅行网站擅用葛优躺图片	社会
获万美元种子轮融资	科技
间谍同盟一部被服装拯救了的电影间谍同盟玛丽昂歌迪亚布拉德皮特新浪娱乐新浪网	娱乐
新疆年未征服这客场	体育
蓝传全智贤靓丽变身	娱乐
苹果售后涉五大霸王条款	科技
中国用招反击特朗普出击中东与伊朗军事合作特朗普中东中国新浪军事新浪网	军事
三少爷燕十三才是尔冬升真爱尔冬升何润东燕十三新浪娱乐新浪网	娱乐
辽媒汤神分才投三分	体育
月全球纯血马一级赛回顾	体育
蔡英文回应川蔡通话一通电话不代表政策转变台湾中美特朗普新浪新闻	国内
易信金融市场进入调整模式	财经
血战钢锯岭曝爆头片段	娱乐
邦达亚洲脱欧忧虑卷土重来	财经
汤普森未来能得分	体育
长城张艺谋赞郑恺一眼就觉得合适郑恺长城张艺谋新浪娱乐新浪网	娱乐
张柏芝遭表白不在乎过去	娱乐
熟人发来请柬网址	科技
小区被曝人贩子偷幼童	社会
曝级探花今夏必要顶薪	体育
日本用细胞制成精子干细胞或解不孕难题干细胞不孕细胞新浪科技新浪网	科技
凄灵室曝迷局版预告	娱乐
快讯半新股盟科控股涨逾半成	财经
女子不顾家人反对裸婚	社会
中国跑步潮为何兴起	体育
牛汇澳洲三季度负增长	财经
国泰君安国际料今日恒指上试点国泰君安国际港股恒指新浪财经新浪网	财经
汇生财富欧洲央行会议临近	财经
艾拓思金价止跌	财经
招银国际观望欧美议息	财经
猿辅导拍照搜题之后再推黑科技	科技
罗曼蒂克导演杜江演童子鸡很合适杜江霍思燕罗曼蒂克消亡史新浪娱乐新浪网	娱乐
新海诚导演作品疑遭中国企业擅自用于手机运营商新浪科技新浪网	科技
台企巨头公开声明支持一个中国	军事
男子厕所捡到同住好友钱包	社会
胡祖六中国企业暂停在美收购步伐胡祖六中国企业海外收购新浪财经新浪网	美股
曝波什考虑下季复出	体育
奇牛国际澳洲季率五年来首现负增长	财经
新任队长比约恩被支持声淹没	体育
黄金或触底	财经
乐基儿装成礼物	娱乐
快讯深股通净流入亿	财经
马季奇外援需尊重中国文化	体育
兴业投资欧元领跌非美	财经
山西焦化亿拟重组资产年内难入财务报表	财经
新华社猎取善良透支社会信用必须被叫停信用罗一笑新浪新闻	其他
伊涅斯塔揭小罗趣事他战皇马前骗了巴萨全队西班牙新浪竞技风暴新浪网	体育
这位正部级女高官很特别	国内
青海年前遗骨身份初步确认	国内
神撞脸怀孕后的竟然越长越像黄晓明黄晓明新浪娱乐新浪娱乐新浪网	娱乐
刘雯早餐就这些终于知道超模咋那么瘦了刘雯超模维密新浪娱乐新浪网	娱乐
陪读母亲吨旧辅导书砌米书井组图家长陪读书井新浪新闻	社会
鲁毅当选广东佛山市委书记鲁毅佛山书记新浪新闻	国内
艾迪西申通快递补充业绩承诺	股市
陈良贤当选广东汕头市委书记汕头市委书记陈良贤新浪新闻	国内
次上看台被罚万镑	体育
罗一笑父亲否认拥有公司	社会
对不起我必须要给神奇动物泼盆凉水哈利波特神奇动物在哪里玩儿电影新浪娱乐新浪网	娱乐
教育部届全国普通高校毕业生预计万人高校毕业生教育部就业新浪新闻	国内
大胜后又有好消息	体育
万达商业两手准备闯关股边排队边找壳	财经
多个新规今日起正式实施	财经
国务院明年继续实施减税降费政策减税增值税提质增效新浪财经新浪网	财经
期股联动	财经
多重风险事件推升贵金属避险需求贵金属货币政策美国新浪财经新浪网	财经
机场身份证通关不简单通关安检身份证新浪财经新浪网	财经
代驾司机驾驶途中出事故	社会
三维丝股东内斗几大谜团待解股东大会股东商贸新浪财经新浪网	财经
证监会联手公安部	财经
央行连发新规强化个人账户管理	财经
罗祥波没想到二股东会同意罢免公司董事股东大会新浪财经新浪网	财经
地产公司爱炒股	股市
股东法院互诉	股市
营改增半年减税近千亿	财经
深圳儿童医院对罗一笑事件发声三次住院万	财经
郑眼看盘大宗商品暴跌股受拖累调整大宗商品股新浪财经新浪网	财经
媒体评流动性担忧极度宽松已成往事	财经
商品市场二度降温	财经
浙金信托曲线上市迎救命稻草大股东兜底上亿坏账证监会浙江东方大股东新浪财经新浪网	财经
解读恒大溢价增持万科意欲何为万科恒大溢价新浪财经新浪网	财经
专家楼市繁荣致严重结构扭曲	财经
熟悉的野蛮人再现	财经
央行公开市场结束连日净回笼	财经
财政部管制地方债	财经
融创股首秀掌控金科股份股权金科股份孙宏斌股新浪财经新浪网	股市
国务院继续大力实施减税降费政策营改增增值税减税降费新浪财经新浪网	财经
点附近折价率收窄定增基金陷好卖难做困境折价率基金困境新浪财经新浪网	财经
潘基文卸任回国后或立即讲话	国际
特朗普威胁中止与古巴正常关系妥协太多无回报古巴特朗普美国新浪新闻	国际
苹果仅免费更换部分电池引不满	财经
中方代表决议无意对朝鲜民生和正常贸易不利朝鲜安理会中国新浪新闻	国际
社科院报告大中城市住房估值普遍过高楼市房价新浪新闻	国内
大量女生借贷不雅照网上流传借钱条件不止裸身借款裸照新浪新闻	社会
罗尔回应未卖房救女深圳这套房家人要住罗尔罗一笑新浪新闻	社会
大量女生借贷不雅照疑泄露	财经
小学老师让家长改作业	社会
父亲状告儿子影响自己招房客获赔万余元儿子老汉房屋新浪新闻	社会
乡干部推行禁牧暴打农民	社会
名男子体内藏毒机场被抓	社会
男子恶意透支信用卡万余元	社会
月份家企业过会	财经
大宗交易骤增近亿元	股市
三江购物上涨十一月夺冠	股市
家公司遭重要股东净增持	财经
美海警欲赴中国海域执法	国内
台当局太平岛演习人道救援	国内
新加坡被指耍苦肉计	国内
台立法院大幅降低罢免门槛	国内
格力会是险资下一个标的中金称被举牌是大概率事件格力电器格力大股东新浪财经新浪网	股市
多名中国移民因卷入欺诈案或被逐出加拿大	国内
韩媒青瓦台选址风水不佳	国际
俄拟立法禁止外国导游	国际
印度最高法院强令看电影先放国歌	国际
二十四节气入选非遗名录	国内
破产之王将任美新商务部长	国际
北京开通网上申请居住证平台	国内
中青报太平间门口醒酒或引发对逝者不敬的争议太平间醒酒新浪新闻	国内
双头董事会互撕	股市
保利地产整合保利置业波折丛生	股市
好想你并购百草味	股市
光伏企业三季报抢装潮后需求疲软	财经
净水器会销骗局背后	科技
美图拟融资亿港元	科技
网红董明珠我永远不会做金融董明珠实体经济格力新浪财经新浪网	财经
孙宏斌旗下企业增持金科股份	财经
前海人寿大幅增持格力电器至	股市
东方航空拟剥离物流业务	股市
沪港通暂现疲态	股市
黑色系熊出没	财经
人民币对美元连升四日	财经
首月你必须了解的件事	体育
湖南湖北等省市今有大雾	国内
供应紧张需求强劲	财经
哥伦比亚飞机坠毁前录音曝光	国际
我国防部回应空军战机穿越宫古海峡还将继续组织国防部组织空军新浪军事新浪网	军事
日本陆上自卫队主力前往南苏丹参加维和行动陆上自卫队南苏丹维和新浪新闻	国际
超豪华车今起加税	国内
路人捡走奶奶手机	社会
男男性行为染上艾滋病	国内
医生连做七台手术后累到倒地打盹图打盹医生新浪新闻	社会
卡斯特罗骨灰在古巴绕境天	国际
麦当劳巨无霸汉堡创造者去世	国际
菲律宾总统我很想亲近中俄	国际
韩国动荡令美日担忧	国际
北京空气重污染橙色预警中小学停止户外活动橙色预警雾霾新浪新闻	国内
天津青海开展电改试点不得人为降低电价电力体制天津市青海省新浪财经新浪网	财经
印控克什米尔地区军事基地遇袭	国际
俄欲开展日俄天然气管道建设磋商	国际
内蒙古党委常委张院忠任包头市委书记图简历王中和包头新浪新闻	国内
发改委积极推动和保障煤炭中长期合同履行合同煤炭企业新浪财经新浪网	财经
北京男男性行为人群艾滋感染率较高艾滋病性行为新浪新闻	国内
菲总统视察反恐部队	国际
韩媒韩军工部门拟明年起设计新型战机韩国新型战机军工新浪新闻	国际
市民为祭祖楼道烧纸	社会
香港今年天气湿热极端	国内
减产千呼万唤始出来大佬此系逆历史潮流历史潮流大佬新浪财经新浪网	财经
国际投资者关注日本重新讨论赌场合法化问题日本赌场合法化新浪新闻	国际
民航实现客机全球追踪每分钟发位置信息客机民航监控新浪新闻	国内
普京访日或冒被暗杀风险	国际
马赛回旋精彩进球齐达内儿子嗨翻伯纳乌西班牙新浪竞技风暴新浪网	体育
印将在与中巴等国边界建铁路	国际
男子因拉货引发纠纷	社会
女子无意漏财被陈尸水底	社会
官方制造业攀至两年高点	财经
派出所副所长违规给自己办个户口	社会
绿营人士蔡英文对宋楚瑜没有什么信心宋楚瑜蔡英文台湾新浪新闻	国内
原广西政协副主席黄世勇任政法委书记图简历黄世勇人事任免广西新浪新闻	国内
南玻管理层宫斗收尾新领导班子上任领导班子副总裁管理层新浪财经新浪网	股市
美国东南部旅游区野火肆虐	国际
韩媒执政党提议朴槿惠明年月下台	国际
美银美林日元疲态料持续	财经
国务院发展权白皮书建立制度体系架构中国特色社会主义发展权国务院新浪新闻	国内
发展权白皮书中国为完善发展权理念作出贡献发展权国务院新浪新闻	国内
韩国外长韩美日会同时发布对朝单边制裁方案尹炳世韩美日单边制裁新浪新闻	国际
普京希望特朗普上任后能恢复俄美关系普京特朗普俄美关系新浪新闻	国际
国务院发展权白皮书中国减少亿多贫困人口中国白皮书贫困人口新浪新闻	国内
泰国副总理泰国王储哇集拉隆功已同意即位泰国国王王储新浪新闻	国际
中国启动修缮百年前在英国北洋水师水兵墓图中国文物北洋水师水兵墓新浪新闻	国内
韩国执政党就总统明年四月辞职六月大选达一致执政党韩国总统辞职新浪新闻	国际
菲总统我很想亲近俄罗斯及中国	国际
刘翔吴莎情路年初见倾心	体育
申花新援感谢青岛中能培养	体育
美法案首度列入台美将领交流	国内
罗一笑骨髓初配成功被证实为谣言骨髓罗一笑新浪新闻	社会
尴尬魔兽秀一条龙运球上演麦基式五大囧	体育
多地月子中心乱象金牌家政人员花钱买证上岗月子中心记者服务新浪财经新浪网	财经
太极集团药监局肉眼检验可以判定产品不合格吗太极集团药监局规则新浪财经新浪网	股市
朴槿惠回乡视察火灾现场	国际
安理会通过决议制裁朝鲜	国内
普京发表国情咨文俄罗斯人团结爱国国情咨文普京新浪新闻	国际
民进党追杀马英九马英九前幕僚不能坐视不理马英九新浪新闻	国内
最严基金子公司监管新规即将落地基金子公司子公司监管新浪财经新浪网	财经
普京俄罗斯人民团结爱国	国际
新生代内线对决精彩纷呈	体育
财政部地方政府专项债务应有稳定的偿还资金来源债务地方政府财政部新浪财经新浪网	财经
普京谈反腐不是做秀	国际
普京谈十月革命百年不许将怨恨拉入现在的生活普京十月革命新浪新闻	国际
普京俄中合作是国家间互利合作的典范普京国情咨文新浪新闻	国际
童道驰任湖北省副省长	国内
老人灌醉准女婿测人品	社会
普京俄不寻求敌人	国际
盘点夏天哪些球队花了冤枉钱	体育
男子为免单狂吃变态辣牛肉丸引发急性胰腺炎免单变态辣新浪新闻	社会
观点西班牙外援大爆发	体育
男子连杀人被警方当场抓获杀人新浪新闻	社会
空中网达成私有化协议	美股
安徽芜湖餐馆爆炸致死	社会
中国品牌海外传播报告发布国际曝光率待提升品牌曝光率新浪新闻	国内
民居失火现烧焦尸体男子因嫖资争执杀人焚尸杀人焚尸新浪新闻	社会
中超确定版权费分红方案均分	体育
世纪大战亿欧大战	体育
导演出柜青春的大门注定是蓝色的桂纶镁陈柏霖同性新浪娱乐新浪网	娱乐
周末观影丨日本年度现象级动画终于来了你的名字三少爷的剑佩小姐的奇幻城堡新浪娱乐新浪网	娱乐
脑洞大开怪诞有趣的鬼才导演回来了波顿佩小姐鬼才新浪娱乐新浪网	娱乐
期货市场催化剂作用显现期货市场作用催化剂新浪财经新浪网	财经
供应偏紧	财经
菜油	财经
欧盟考虑进一步制裁朝鲜	国际
万达十年亿元打造中国杯	体育
中央环保督察已覆盖半数省份主盯不作为乱作为环保环境保护中央新浪新闻	国内
国家重点研发计划经费版图明晰	财经
经济运行企稳并现阶段性回升	财经
深港通内地个人投资者	财经
星河生物弃农从医	股市
欧佩克缘何八年来首次减产欧佩克页岩油市场新浪财经新浪网	财经
